./Build.PL	LGPL-2.1	2018 Dominique Dumont.
./CONTRIBUTING.md	UNKNOWN	*No copyright*
./Changes	UNKNOWN	*No copyright*
./LICENSE	LGPL-2.1	2018 Dominique Dumont.
./MANIFEST	UNKNOWN	*No copyright*
./MANIFEST.SKIP	UNKNOWN	*No copyright*
./META.json	UNKNOWN	*No copyright*
./META.yml	UNKNOWN	*No copyright*
./README.md	UNKNOWN	*No copyright*
./build-from-git.md	UNKNOWN	*No copyright*
./weaver.ini	UNKNOWN	*No copyright*
./debian/changelog	UNKNOWN	*No copyright*
./debian/compat	UNKNOWN	*No copyright*
./debian/control	UNKNOWN	*No copyright*
./debian/copyright	Artistic and/or GPL-1	-format/1.0/
./debian/libconfig-model-backend-yaml-perl.docs	UNKNOWN	*No copyright*
./debian/rules	UNKNOWN	*No copyright*
./debian/watch	UNKNOWN	*No copyright*
./t/README.md	UNKNOWN	*No copyright*
./t/backend_yaml.t	UNKNOWN	*No copyright*
./t/model_tests.t	UNKNOWN	*No copyright*
./debian/source/format	UNKNOWN	*No copyright*
./debian/upstream/metadata	UNKNOWN	*No copyright*
./t/lib/test_yaml_model.pl	LGPL-2.1	2018 Dominique Dumont.
./t/model_tests.d/backend-yaml-data-test-conf.pl	LGPL-2.1	2018 Dominique Dumont.
./t/model_tests.d/backend-yaml-test-conf.pl	LGPL-2.1	2018 Dominique Dumont.
./t/model_tests.d/backend-yaml-data-examples/basic	UNKNOWN	*No copyright*
./t/model_tests.d/backend-yaml-examples/basic	UNKNOWN	*No copyright*
./lib/Config/Model/Backend/Yaml.pm	LGPL-2.1	2018 Dominique Dumont.
