./Changes	UNKNOWN	*No copyright*
./LICENSE	Artistic or GPL-1+ and/or GPL-1	2018 Dominique Dumont.
./MANIFEST	UNKNOWN	*No copyright*
./MANIFEST.SKIP	UNKNOWN	*No copyright*
./META.json	UNKNOWN	*No copyright*
./META.yml	UNKNOWN	*No copyright*
./Makefile.PL	Artistic or GPL-1+	2018 Dominique Dumont.
./README	Artistic or GPL-1+	2018 Dominique Dumont.
./README.md	UNKNOWN	*No copyright*
./debian/changelog	UNKNOWN	*No copyright*
./debian/control	UNKNOWN	*No copyright*
./debian/copyright	Artistic and/or GPL-1+	-format/1.0/
./debian/rules	UNKNOWN	*No copyright*
./debian/watch	UNKNOWN	*No copyright*
./t/license-summary.t	UNKNOWN	*No copyright*
./t/pod.t	UNKNOWN	*No copyright*
./t/short-name-fallback.t	UNKNOWN	*No copyright*
./t/summary_or_text.t	UNKNOWN	*No copyright*
./debian/source/format	UNKNOWN	*No copyright*
./debian/upstream/metadata	UNKNOWN	*No copyright*
./lib/Software/LicenseMoreUtils.pm	Artistic or GPL-1+	2018 Dominique Dumont.
./lib/Software/LicenseMoreUtils/LGPL_2.pm	Artistic or GPL-1+	2018 Dominique Dumont.
./lib/Software/LicenseMoreUtils/LicenseWithSummary.pm	Artistic or GPL-1+	2018 Dominique Dumont.
./lib/Software/LicenseMoreUtils/debian-summaries.yml	Apache-2.0 and/or Artistic and/or GFDL-1.2+ and/or GFDL-1.3+ and/or GPL-1 and/or GPL-2	*No copyright*
